25 400
-1 -1 -1 -1 -1 -1 -1 -1 -1 -1 -1 -1 -1 -1 -1 -1 -1 -1 -1 -1 -1 -1 -1 -1 -1
-1 -1 -1 -1 -1 -1 -1 -1 -1 -1 -1 -1 -1 -1 -1 -1 -1 -1 -1 -1 -1 -1 -1 -1 -1
-1 -1 -1 -1 -1 -1 -1 -1 -1 -1 -1 -1 -1 -1 -1 -1 -1 -1 -1 -1 -1 -1 -1 -1 -1
-1 -1 -1 -1 -1 -1 -1 -1 -1 -1 -1 -1 -1 -1 -1 -1 -1 -1 -1 -1 -1 -1 45 45 45
-1 -1 -1 -1 -1 -1 -1 -1 -1 -1 -1 -1 -1 -1 -1 -1 -1 -1 -1 -1 -1 -1 46 -1 -1
-1 -1 -1 -1 -1 -1 -1 -1 -1 -1 -1 -1 -1 -1 -1 -1 -1 -1 -1 -1 -1 -1 -1 -1 -1
-1 -1 -1 -1 -1 -1 -1 -1 -1 -1 -1 -1 -1 -1 20 -1 -1 20 -1 -1 -1 -1 -1 -1 -1
-1 -1 -1 -1 -1 -1 -1 -1 -1 -1 -1 -1 -1 -1 -1 -1 -1 -1 -1 -1 -1 -1 -1 -1 -1
-1 -1 -1 -1 -1 -1 -1 -1 -1 -1 -1 -1 -1 20 -1 -1 -1 -1 -1 -1 -1 -1 -1 -1 -1
20 20 20 20 20 20 20 20 -1 -1 -1 20 -1 -1 -1 -1 -1 -1 -1 -1 -1 -1 -1 -1 -1
-1 -1 -1 -1 -1 -1 -1 -1 -1 -1 -1 -1 -1 -1 -1 -1 -1 -1 -1 -1 -1 -1 -1 -1 -1
-1 -1 -1 -1 20 -1 -1 -1 -1 -1 -1 -1 -1 -1 -1 -1 -1 -1 -1 -1 -1 -1 -1 -1 -1
-1 -1 -1 -1 20 20 20 -1 -1 -1 -1 -1 -1 -1 -1 -1 -1 -1 -1 -1 -1 -1 -1 -1 -1
-1 -1 -1 -1 -1 -1 -1 20 -1 20 -1 20 20 20 20 20 20 20 20 20 -1 -1 -1 -1 -1
-1 -1 -1 -1 -1 -1 -1 -1 -1 -1 -1 -1 -1 -1 -1 -1 -1 -1 -1 20 20 20 -1 -1 -1
-1 -1 -1 -1 -1 -1 -1 -1 -1 -1 -1 -1 -1 -1 -1 -1 -1 -1 -1 -1 -1 -1 -1 -1 -1
-1 -1 -1 -1 -1 -1 -1 -1 -1 -1 -1 -1 -1 -1 -1 -1 -1 -1 -1 -1 -1 -1 -1 -1 -1
-1 -1 -1 -1 -1 -1 -1 -1 -1 20 -1 -1 -1 -1 -1 -1 -1 -1 -1 -1 -1 -1 -1 -1 -1
-1 20 -1 -1 -1 -1 -1 -1 -1 -1 -1 -1 -1 -1 -1 -1 -1 20 -1 -1 -1 -1 -1 -1 -1
-1 20 -1 -1 -1 -1 -1 -1 -1 -1 -1 -1 -1 -1 -1 -1 20 20 20 20 -1 -1 -1 -1 -1
-1 -1 -1 -1 -1 -1 -1 -1 -1 -1 -1 -1 -1 -1 -1 -1 -1 -1 -1 20 20 -1 -1 20 -1
-1 -1 -1 -1 -1 -1 -1 -1 -1 -1 -1 -1 -1 -1 -1 -1 -1 -1 -1 -1 -1 -1 -1 20 -1
-1 -1 -1 -1 -1 -1 -1 -1 -1 -1 -1 -1 -1 -1 -1 -1 -1 -1 -1 -1 -1 -1 -1 -1 -1
-1 -1 -1 -1 -1 20 -1 -1 -1 -1 -1 -1 -1 -1 -1 -1 -1 -1 -1 -1 -1 -1 -1 -1 -1
-1 -1 -1 -1 -1 -1 -1 -1 -1 -1 -1 -1 -1 -1 -1 -1 -1 -1 -1 -1 -1 -1 -1 -1 -1
-1 -1 -1 -1 -1 -1 -1 -1 -1 -1 -1 -1 20 -1 -1 -1 -1 -1 -1 -1 -1 -1 -1 -1 -1
-1 -1 -1 -1 -1 -1 -1 -1 -1 -1 -1 -1 -1 -1 -1 -1 -1 -1 -1 -1 -1 -1 -1 -1 -1
-1 -1 -1 -1 -1 -1 -1 -1 -1 -1 -1 -1 -1 -1 -1 -1 -1 -1 -1 20 20 -1 -1 -1 -1
-1 -1 -1 -1 -1 -1 -1 -1 -1 -1 -1 -1 -1 -1 -1 -1 -1 -1 -1 -1 -1 -1 -1 -1 -1
-1 -1 -1 -1 -1 -1 -1 -1 -1 -1 -1 -1 -1 -1 -1 -1 -1 -1 -1 -1 -1 -1 -1 -1 -1
-1 -1 -1 -1 -1 -1 -1 -1 -1 -1 -1 -1 -1 -1 -1 -1 -1 -1 -1 -1 -1 -1 -1 -1 -1
-1 -1 -1 -1 -1 -1 -1 -1 -1 -1 -1 -1 -1 -1 -1 -1 -1 -1 -1 -1 -1 -1 -1 -1 -1
-1 -1 -1 -1 -1 -1 -1 -1 -1 -1 -1 -1 -1 -1 -1 -1 -1 -1 -1 -1 -1 -1 -1 -1 -1
-1 -1 -1 -1 -1 -1 -1 -1 -1 -1 -1 -1 -1 -1 -1 -1 -1 -1 -1 -1 -1 -1 -1 -1 -1
-1 -1 -1 -1 -1 -1 -1 -1 -1 -1 -1 -1 -1 -1 -1 -1 -1 -1 -1 -1 -1 -1 20 20 -1
-1 -1 -1 20 20 -1 -1 -1 -1 -1 -1 -1 -1 -1 -1 -1 -1 -1 -1 -1 -1 -1 -1 -1 -1
-1 -1 -1 -1 20 -1 -1 -1 -1 -1 -1 -1 -1 -1 -1 -1 -1 -1 -1 -1 -1 -1 -1 -1 -1
-1 -1 -1 -1 -1 -1 -1 -1 -1 -1 -1 -1 -1 -1 -1 -1 -1 -1 -1 -1 -1 -1 -1 -1 -1
-1 -1 -1 -1 -1 -1 -1 -1 -1 -1 -1 -1 -1 -1 -1 20 -1 -1 -1 -1 -1 -1 -1 -1 -1
-1 -1 -1 -1 -1 -1 -1 -1 -1 -1 -1 -1 -1 -1 -1 -1 -1 -1 -1 -1 -1 -1 -1 -1 -1
20 20 -1 -1 -1 -1 -1 -1 -1 -1 -1 -1 -1 -1 -1 -1 -1 -1 -1 -1 -1 -1 -1 -1 -1
-1 -1 -1 -1 -1 -1 -1 -1 -1 -1 -1 -1 -1 -1 -1 -1 -1 -1 -1 -1 -1 -1 -1 -1 -1
-1 -1 -1 -1 -1 -1 -1 -1 -1 -1 -1 -1 -1 -1 -1 -1 -1 -1 -1 -1 -1 -1 -1 -1 -1
-1 -1 -1 -1 -1 -1 -1 -1 -1 -1 -1 -1 -1 -1 -1 -1 -1 -1 -1 -1 -1 -1 -1 -1 -1
-1 -1 -1 -1 -1 -1 -1 -1 -1 -1 -1 -1 -1 -1 -1 -1 -1 -1 -1 -1 -1 -1 -1 -1 -1
-1 -1 -1 -1 -1 -1 -1 -1 -1 -1 -1 -1 -1 -1 -1 -1 -1 -1 -1 -1 -1 -1 -1 -1 -1
-1 -1 20 -1 -1 -1 -1 -1 -1 -1 -1 -1 -1 -1 -1 -1 -1 -1 -1 -1 -1 -1 -1 -1 -1
-1 -1 20 -1 -1 -1 -1 -1 -1 -1 -1 20 20 -1 -1 -1 -1 -1 -1 -1 -1 -1 -1 -1 -1
-1 20 20 20 20 20 20 20 20 20 20 20 20 -1 -1 20 20 -1 -1 -1 -1 -1 45 20 20
-1 -1 -1 -1 -1 -1 -1 -1 -1 -1 -1 -1 -1 -1 -1 -1 -1 -1 -1 -1 -1 -1 46 -1 -1
-1 -1 -1 -1 -1 -1 -1 -1 -1 -1 -1 -1 -1 -1 20 20 20 -1 -1 -1 -1 -1 -1 -1 -1
-1 -1 -1 -1 -1 -1 -1 -1 -1 -1 -1 -1 -1 -1 -1 -1 -1 20 20 20 20 -1 -1 -1 -1
-1 -1 -1 -1 -1 -1 20 20 -1 -1 -1 -1 -1 -1 -1 -1 -1 -1 -1 -1 20 -1 -1 -1 -1
-1 -1 -1 -1 -1 -1 -1 -1 -1 -1 -1 -1 -1 -1 -1 -1 -1 -1 -1 20 20 -1 -1 -1 -1
-1 -1 -1 -1 -1 -1 -1 -1 -1 -1 -1 -1 -1 -1 -1 -1 -1 -1 -1 20 45 45 -1 -1 -1
-1 -1 -1 -1 -1 -1 -1 -1 -1 -1 -1 -1 -1 -1 -1 -1 -1 -1 -1 -1 20 20 -1 -1 -1
-1 -1 20 -1 -1 -1 -1 -1 -1 -1 -1 45 45 45 -1 -1 -1 -1 -1 -1 -1 20 -1 -1 -1
-1 -1 20 -1 -1 -1 -1 -1 -1 -1 -1 46 -1 -1 -1 -1 -1 -1 -1 -1 -1 20 -1 -1 -1
-1 -1 -1 -1 -1 -1 -1 -1 -1 -1 -1 -1 -1 -1 -1 -1 -1 -1 -1 -1 -1 20 -1 20 20
-1 -1 -1 -1 -1 -1 -1 -1 -1 -1 -1 -1 -1 -1 -1 -1 -1 -1 -1 -1 -1 20 -1 -1 -1
-1 -1 -1 -1 -1 -1 -1 -1 -1 -1 -1 -1 -1 -1 -1 -1 -1 -1 -1 -1 -1 -1 -1 -1 -1
-1 -1 -1 -1 -1 -1 -1 -1 -1 -1 -1 -1 -1 -1 -1 -1 -1 -1 -1 -1 -1 -1 -1 -1 -1
-1 -1 -1 -1 20 20 45 45 -1 -1 -1 -1 -1 -1 -1 -1 -1 45 45 20 20 -1 -1 -1 -1
-1 -1 -1 -1 -1 -1 46 -1 -1 -1 -1 -1 -1 -1 -1 -1 -1 -1 -1 -1 -1 -1 -1 -1 -1
-1 -1 -1 -1 -1 -1 -1 -1 -1 -1 -1 -1 -1 -1 -1 -1 -1 -1 -1 -1 -1 -1 -1 -1 -1
-1 -1 -1 -1 -1 -1 -1 -1 -1 -1 -1 -1 -1 -1 -1 -1 -1 -1 -1 -1 -1 -1 -1 -1 -1
20 -1 -1 -1 -1 -1 -1 -1 -1 -1 -1 -1 -1 -1 -1 -1 -1 -1 -1 -1 -1 -1 -1 -1 -1
20 45 45 -1 -1 -1 -1 -1 -1 -1 -1 -1 -1 -1 -1 -1 -1 -1 -1 -1 -1 20 45 45 20
-1 -1 -1 -1 -1 -1 -1 -1 -1 -1 -1 -1 -1 -1 -1 -1 -1 -1 -1 -1 -1 -1 -1 46 -1
-1 -1 -1 -1 -1 -1 -1 -1 -1 -1 -1 -1 -1 -1 -1 -1 -1 -1 -1 -1 -1 -1 -1 -1 -1
-1 -1 -1 -1 -1 -1 -1 -1 -1 -1 -1 -1 -1 -1 -1 -1 -1 -1 -1 -1 -1 -1 -1 -1 -1
-1 -1 -1 -1 -1 -1 -1 -1 -1 -1 -1 45 45 45 20 -1 -1 -1 -1 -1 -1 -1 -1 -1 -1
-1 -1 -1 -1 -1 -1 -1 -1 -1 -1 -1 -1 46 -1 -1 -1 -1 -1 -1 -1 -1 -1 -1 -1 -1
-1 -1 -1 -1 -1 -1 -1 -1 -1 -1 -1 -1 -1 -1 -1 -1 -1 -1 -1 -1 -1 -1 -1 -1 -1
-1 -1 -1 -1 -1 -1 -1 -1 -1 -1 -1 -1 -1 -1 -1 -1 -1 -1 -1 -1 -1 -1 -1 -1 -1
-1 -1 -1 -1 -1 -1 -1 -1 -1 -1 -1 -1 -1 -1 -1 -1 -1 -1 -1 -1 -1 -1 -1 -1 -1
-1 -1 -1 -1 -1 -1 -1 -1 -1 -1 -1 -1 -1 -1 -1 -1 -1 -1 -1 -1 -1 -1 -1 -1 -1
-1 -1 -1 -1 -1 20 20 20 20 -1 -1 -1 -1 -1 -1 -1 -1 -1 20 20 -1 -1 -1 -1 -1
-1 -1 -1 -1 -1 -1 -1 -1 -1 -1 -1 -1 -1 -1 -1 -1 -1 -1 -1 20 -1 -1 -1 -1 -1
-1 -1 -1 -1 -1 -1 -1 -1 -1 -1 -1 -1 -1 -1 -1 -1 -1 -1 -1 -1 -1 -1 -1 -1 -1
-1 -1 -1 -1 -1 -1 -1 -1 -1 -1 -1 -1 -1 -1 -1 -1 -1 -1 -1 -1 -1 -1 -1 -1 -1
-1 -1 -1 -1 -1 -1 -1 -1 -1 -1 -1 -1 -1 -1 -1 -1 -1 -1 -1 -1 -1 -1 -1 -1 -1
-1 -1 -1 -1 -1 -1 -1 -1 -1 -1 -1 -1 -1 -1 -1 -1 -1 -1 -1 -1 -1 -1 -1 -1 -1
45 -1 -1 -1 -1 -1 -1 -1 -1 -1 -1 -1 -1 -1 -1 -1 -1 -1 -1 -1 -1 -1 -1 -1 45
46 -1 -1 -1 -1 -1 -1 -1 -1 -1 -1 -1 -1 -1 -1 -1 -1 -1 -1 -1 -1 -1 -1 -1 46
-1 -1 -1 -1 -1 -1 -1 -1 -1 -1 -1 -1 -1 -1 -1 -1 -1 -1 -1 -1 -1 -1 -1 -1 -1
-1 -1 -1 -1 -1 -1 -1 -1 -1 -1 -1 -1 -1 -1 -1 -1 -1 -1 -1 -1 -1 -1 -1 -1 -1
-1 -1 -1 -1 -1 -1 -1 -1 -1 -1 -1 -1 -1 -1 -1 -1 -1 -1 -1 -1 -1 -1 -1 -1 -1
-1 -1 -1 20 20 20 20 20 20 20 20 20 20 20 20 20 20 -1 -1 -1 -1 -1 -1 -1 -1
-1 -1 -1 20 -1 -1 -1 20 20 -1 -1 -1 -1 -1 -1 -1 -1 20 20 20 20 20 20 -1 -1
-1 -1 -1 20 -1 -1 -1 20 -1 -1 -1 -1 -1 -1 -1 -1 -1 -1 -1 -1 -1 -1 -1 -1 -1
-1 -1 -1 20 -1 -1 -1 -1 -1 -1 -1 -1 -1 -1 -1 -1 -1 -1 -1 -1 -1 -1 -1 -1 -1
-1 -1 -1 20 20 20 -1 -1 -1 -1 -1 -1 -1 -1 -1 -1 -1 -1 -1 20 20 20 20 -1 -1
-1 -1 20 20 20 20 20 20 20 20 20 20 20 20 20 20 20 20 20 20 20 20 20 20 20
-1 -1 -1 -1 -1 -1 -1 -1 -1 -1 -1 -1 -1 -1 -1 -1 -1 -1 -1 -1 -1 -1 -1 -1 -1
-1 -1 45 45 45 -1 -1 -1 -1 -1 -1 -1 -1 -1 -1 -1 -1 -1 -1 -1 45 45 45 -1 -1
-1 -1 -1 46 -1 -1 -1 -1 -1 -1 -1 -1 -1 -1 -1 -1 -1 -1 -1 -1 20 -1 46 -1 -1
-1 -1 20 -1 -1 -1 -1 -1 -1 -1 -1 -1 -1 -1 -1 -1 -1 -1 -1 -1 -1 -1 -1 -1 -1
-1 20 20 -1 20 -1 -1 -1 -1 -1 20 -1 -1 -1 -1 -1 -1 -1 20 20 -1 -1 -1 -1 -1
20 20 20 20 20 20 20 20 20 20 20 20 -1 20 20 -1 -1 -1 20 20 -1 -1 -1 -1 -1
-1 20 -1 20 20 -1 -1 -1 20 20 20 20 20 20 20 20 20 20 20 20 20 20 20 20 20
-1 -1 -1 -1 -1 -1 -1 -1 20 20 20 20 20 20 20 20 20 20 -1 -1 -1 -1 20 20 20
-1 -1 -1 -1 -1 -1 -1 -1 -1 20 20 -1 -1 -1 -1 -1 20 -1 -1 -1 -1 -1 20 -1 20
20 20 20 20 -1 -1 -1 -1 -1 20 -1 -1 -1 -1 -1 -1 -1 -1 -1 -1 -1 -1 20 -1 -1
22 20 20 20 20 20 22 20 20 20 20 20 20 20 20 20 20 20 -1 -1 -1 20 -1 20 -1
27 -1 20 -1 -1 -1 27 -1 -1 -1 -1 -1 -1 -1 -1 -1 -1 20 20 20 20 20 20 20 20
27 20 -1 -1 -1 -1 27 -1 -1 -1 -1 -1 -1 -1 -1 -1 -1 -1 -1 -1 -1 -1 -1 -1 -1
27 20 -1 -1 -1 -1 27 -1 -1 -1 -1 -1 -1 -1 -1 -1 -1 20 20 -1 -1 -1 -1 -1 -1
27 -1 -1 -1 -1 -1 27 -1 20 20 -1 -1 -1 -1 -1 -1 -1 -1 20 -1 -1 -1 -1 -1 -1
27 -1 -1 20 20 20 27 20 20 20 20 20 20 20 -1 -1 -1 -1 20 -1 -1 -1 -1 -1 -1
27 -1 -1 -1 -1 -1 27 -1 -1 -1 -1 -1 -1 20 20 20 20 20 20 20 20 20 20 20 20
27 -1 -1 -1 -1 -1 27 -1 -1 -1 -1 -1 -1 -1 -1 -1 -1 20 20 -1 -1 -1 -1 20 20
27 -1 -1 -1 -1 -1 27 -1 -1 -1 -1 -1 -1 -1 -1 -1 -1 -1 20 -1 -1 -1 -1 -1 -1
49 -1 -1 -1 -1 -1 51 -1 -1 -1 -1 -1 -1 -1 -1 -1 -1 -1 20 -1 -1 -1 -1 -1 -1
-1 -1 -1 -1 -1 -1 -1 -1 -1 -1 -1 -1 -1 -1 -1 -1 -1 -1 20 -1 -1 -1 -1 -1 -1
-1 -1 -1 -1 -1 -1 -1 -1 -1 -1 -1 -1 -1 -1 -1 -1 -1 -1 20 -1 -1 -1 -1 -1 -1
-1 -1 -1 -1 -1 -1 -1 -1 -1 -1 -1 -1 -1 -1 -1 -1 -1 -1 -1 -1 -1 -1 -1 -1 -1
-1 -1 20 20 20 -1 -1 -1 -1 -1 -1 -1 -1 -1 -1 -1 -1 -1 20 -1 -1 -1 -1 -1 -1
-1 -1 20 20 -1 -1 -1 -1 -1 -1 -1 -1 -1 -1 -1 -1 -1 -1 -1 -1 -1 -1 -1 -1 -1
-1 -1 -1 20 20 20 20 -1 -1 -1 -1 -1 -1 -1 -1 -1 -1 -1 -1 -1 -1 -1 -1 -1 -1
-1 -1 -1 -1 -1 20 20 20 20 20 20 -1 20 -1 20 20 -1 -1 -1 -1 -1 -1 -1 -1 -1
-1 -1 -1 -1 -1 -1 -1 20 20 -1 20 20 20 20 20 20 20 20 20 20 -1 -1 -1 -1 -1
-1 -1 -1 -1 -1 -1 -1 -1 -1 -1 -1 -1 -1 20 20 20 20 20 20 20 -1 -1 -1 -1 -1
-1 -1 -1 -1 -1 -1 -1 -1 -1 -1 -1 -1 -1 -1 -1 -1 -1 -1 20 20 -1 20 20 20 -1
-1 -1 -1 -1 -1 -1 -1 20 -1 -1 -1 -1 -1 -1 -1 -1 -1 -1 -1 -1 -1 -1 -1 -1 -1
-1 -1 -1 -1 -1 -1 -1 -1 -1 -1 -1 -1 -1 -1 -1 -1 -1 -1 -1 -1 -1 -1 -1 -1 -1
-1 -1 -1 -1 -1 -1 -1 -1 -1 -1 -1 -1 -1 -1 -1 -1 -1 -1 -1 -1 -1 -1 -1 -1 -1
-1 -1 -1 -1 -1 -1 -1 -1 -1 -1 -1 -1 -1 -1 -1 -1 -1 -1 -1 -1 -1 -1 -1 20 20
-1 -1 -1 -1 -1 -1 -1 -1 -1 -1 -1 -1 -1 -1 -1 -1 -1 -1 -1 -1 -1 -1 -1 -1 -1
-1 -1 -1 -1 -1 -1 -1 -1 -1 -1 -1 -1 -1 -1 -1 -1 -1 -1 -1 -1 -1 -1 -1 -1 -1
-1 -1 -1 -1 -1 -1 -1 -1 -1 -1 -1 -1 -1 20 -1 -1 -1 -1 -1 -1 -1 -1 -1 -1 -1
-1 -1 -1 -1 -1 -1 -1 -1 -1 -1 -1 -1 20 20 -1 -1 -1 -1 -1 -1 -1 -1 -1 -1 -1
-1 -1 -1 -1 -1 -1 -1 -1 -1 -1 -1 -1 20 20 20 20 -1 -1 -1 -1 -1 -1 -1 -1 -1
-1 -1 -1 -1 -1 -1 -1 -1 -1 -1 -1 -1 -1 -1 -1 20 20 20 -1 -1 -1 -1 -1 -1 -1
-1 -1 -1 -1 -1 -1 -1 -1 -1 -1 -1 -1 -1 -1 -1 -1 -1 20 20 20 20 -1 -1 -1 -1
-1 -1 -1 -1 -1 -1 -1 -1 -1 -1 -1 -1 -1 -1 -1 -1 -1 -1 -1 -1 20 -1 -1 -1 -1
-1 -1 -1 -1 -1 -1 -1 -1 -1 -1 -1 -1 -1 -1 -1 -1 -1 -1 -1 -1 -1 -1 -1 -1 -1
20 20 20 20 20 20 20 -1 -1 -1 -1 -1 -1 -1 -1 -1 -1 -1 -1 -1 -1 -1 -1 -1 -1
20 20 20 20 20 20 -1 -1 -1 -1 -1 -1 -1 -1 -1 -1 -1 -1 -1 -1 -1 -1 -1 -1 -1
-1 -1 -1 -1 -1 -1 -1 -1 -1 -1 -1 -1 -1 -1 -1 -1 -1 -1 -1 -1 -1 -1 -1 -1 -1
-1 -1 -1 -1 -1 -1 -1 -1 -1 -1 -1 -1 -1 -1 -1 -1 -1 -1 -1 -1 -1 -1 -1 -1 -1
-1 -1 -1 -1 -1 -1 -1 -1 -1 -1 -1 -1 -1 -1 -1 -1 -1 -1 -1 -1 -1 -1 20 20 20
-1 -1 -1 -1 -1 -1 -1 -1 -1 -1 20 -1 -1 -1 -1 -1 -1 -1 -1 -1 -1 -1 -1 -1 -1
-1 -1 -1 -1 -1 -1 -1 -1 -1 -1 20 -1 -1 -1 -1 -1 -1 -1 -1 -1 -1 -1 -1 -1 -1
-1 -1 -1 -1 -1 -1 -1 -1 -1 -1 -1 -1 -1 -1 -1 -1 -1 20 -1 -1 -1 -1 -1 -1 -1
-1 -1 -1 -1 -1 -1 -1 -1 -1 -1 -1 -1 -1 -1 -1 -1 -1 -1 -1 -1 -1 -1 -1 -1 -1
-1 -1 -1 -1 -1 -1 -1 -1 -1 -1 -1 -1 -1 -1 -1 -1 -1 -1 -1 -1 -1 -1 -1 -1 -1
-1 -1 -1 -1 -1 -1 -1 -1 -1 -1 -1 -1 20 20 20 20 20 -1 -1 -1 -1 -1 -1 -1 -1
-1 -1 -1 -1 -1 -1 -1 -1 -1 -1 -1 -1 -1 -1 -1 -1 -1 -1 -1 -1 -1 -1 -1 -1 -1
-1 -1 -1 -1 -1 -1 -1 -1 -1 -1 -1 -1 -1 -1 -1 -1 -1 -1 -1 -1 -1 -1 -1 -1 -1
-1 -1 20 -1 -1 -1 -1 -1 -1 20 20 20 20 20 20 20 20 20 20 20 -1 -1 -1 -1 -1
20 20 20 20 20 20 20 20 20 20 20 20 20 20 20 20 20 20 20 20 20 20 20 20 20
-1 -1 -1 23 23 23 23 23 -1 -1 -1 -1 -1 -1 20 20 20 -1 -1 -1 -1 -1 -1 -1 -1
-1 -1 -1 49 20 -1 51 -1 -1 -1 -1 -1 -1 -1 -1 -1 -1 -1 -1 -1 -1 -1 -1 -1 -1
-1 -1 -1 -1 -1 -1 -1 -1 -1 -1 -1 -1 -1 -1 -1 -1 -1 -1 -1 -1 -1 -1 -1 -1 -1
-1 -1 -1 -1 -1 -1 -1 -1 -1 -1 -1 -1 -1 -1 -1 -1 -1 -1 -1 -1 -1 -1 -1 -1 -1
-1 20 -1 -1 -1 -1 -1 -1 -1 -1 -1 -1 -1 -1 -1 -1 20 20 20 20 20 20 -1 -1 -1
20 -1 20 20 -1 -1 -1 -1 -1 -1 -1 -1 -1 -1 -1 -1 23 23 23 20 20 -1 -1 -1 -1
-1 -1 -1 20 -1 -1 -1 -1 -1 -1 -1 -1 -1 -1 -1 -1 49 20 51 20 20 -1 -1 22 -1
-1 -1 -1 -1 20 -1 -1 -1 -1 -1 -1 -1 -1 -1 -1 -1 -1 20 20 -1 -1 -1 -1 27 -1
-1 -1 -1 -1 20 -1 -1 -1 -1 -1 -1 -1 -1 -1 -1 -1 -1 -1 20 -1 -1 -1 -1 27 -1
-1 -1 -1 -1 20 20 -1 -1 -1 -1 -1 -1 -1 -1 -1 -1 -1 -1 20 -1 -1 -1 -1 27 -1
-1 -1 -1 -1 20 20 20 -1 -1 -1 20 -1 -1 -1 -1 -1 -1 -1 22 -1 -1 -1 -1 27 -1
-1 -1 -1 -1 -1 -1 20 20 -1 20 -1 -1 -1 -1 -1 -1 -1 -1 27 -1 -1 -1 -1 27 -1
-1 -1 -1 -1 -1 -1 -1 20 20 -1 -1 -1 -1 -1 -1 -1 -1 20 27 -1 -1 -1 -1 -1 -1
-1 -1 -1 -1 -1 -1 -1 20 20 20 -1 -1 -1 -1 -1 -1 -1 20 27 -1 -1 -1 -1 -1 -1
-1 -1 -1 -1 -1 -1 -1 -1 -1 20 -1 -1 -1 -1 -1 -1 -1 20 27 -1 -1 -1 -1 -1 -1
-1 -1 -1 -1 -1 -1 -1 -1 -1 20 -1 -1 -1 -1 -1 -1 -1 -1 51 -1 -1 -1 -1 -1 -1
-1 -1 -1 -1 -1 -1 -1 -1 -1 -1 20 -1 -1 -1 -1 -1 -1 -1 -1 -1 -1 -1 -1 -1 -1
-1 -1 -1 -1 -1 -1 -1 -1 -1 -1 20 20 -1 -1 -1 -1 -1 -1 -1 -1 -1 -1 -1 24 26
20 -1 -1 -1 -1 -1 -1 -1 -1 -1 -1 -1 20 -1 -1 -1 -1 -1 -1 -1 -1 -1 -1 23 23
20 -1 -1 -1 -1 -1 -1 -1 -1 -1 -1 -1 -1 20 -1 -1 -1 -1 -1 -1 -1 -1 -1 49 -1
20 -1 -1 -1 -1 -1 -1 20 20 -1 20 20 20 20 -1 -1 -1 -1 -1 -1 -1 -1 -1 -1 -1
20 20 20 20 20 20 20 20 20 20 20 20 20 20 20 20 20 20 20 20 20 20 20 20 20
22 -1 -1 -1 -1 -1 -1 -1 -1 -1 -1 -1 -1 -1 -1 -1 -1 -1 -1 23 -1 -1 -1 -1 20
27 -1 -1 -1 -1 -1 -1 -1 -1 -1 -1 -1 -1 -1 -1 -1 -1 -1 -1 51 -1 -1 -1 -1 -1
27 -1 -1 -1 -1 -1 -1 20 20 20 20 20 20 20 -1 -1 -1 -1 -1 -1 -1 -1 -1 -1 -1
27 -1 -1 23 23 20 -1 23 23 23 23 23 23 23 20 -1 -1 -1 -1 -1 -1 -1 -1 -1 -1
27 -1 -1 -1 -1 -1 -1 27 27 27 27 27 27 27 20 -1 -1 -1 -1 -1 -1 -1 -1 -1 -1
27 -1 -1 -1 -1 -1 -1 27 27 27 27 27 27 27 20 -1 -1 -1 -1 -1 -1 -1 20 -1 -1
27 -1 -1 -1 -1 -1 -1 20 49 20 20 20 20 51 20 -1 -1 -1 -1 20 20 23 23 -1 -1
27 -1 -1 -1 -1 -1 -1 20 20 20 20 20 20 20 20 -1 -1 -1 -1 20 20 20 20 -1 -1
-1 -1 -1 -1 -1 -1 -1 20 20 20 20 20 20 20 20 -1 -1 -1 -1 -1 -1 -1 -1 -1 -1
-1 -1 -1 -1 -1 -1 -1 -1 -1 -1 -1 -1 -1 -1 -1 -1 -1 -1 -1 -1 -1 -1 -1 -1 22
-1 -1 -1 20 -1 -1 -1 -1 -1 -1 -1 -1 -1 -1 -1 -1 -1 -1 -1 -1 -1 -1 -1 -1 27
-1 -1 -1 23 23 -1 -1 -1 -1 -1 20 20 20 20 20 20 20 -1 -1 -1 -1 -1 -1 -1 27
-1 -1 -1 49 -1 -1 -1 -1 -1 -1 20 -1 -1 -1 -1 -1 -1 -1 -1 -1 -1 -1 -1 -1 27
-1 -1 -1 -1 -1 -1 -1 -1 -1 20 -1 -1 -1 -1 -1 -1 -1 -1 -1 -1 -1 -1 -1 -1 27
-1 -1 -1 -1 -1 -1 -1 -1 -1 20 -1 -1 -1 -1 -1 -1 -1 -1 -1 -1 -1 -1 -1 -1 49
-1 -1 -1 -1 -1 -1 -1 -1 -1 20 -1 -1 -1 -1 -1 -1 -1 -1 -1 -1 -1 -1 -1 -1 -1
-1 -1 -1 -1 -1 -1 -1 -1 -1 20 -1 -1 -1 -1 -1 -1 -1 -1 20 20 -1 -1 -1 -1 -1
-1 -1 -1 -1 -1 -1 -1 -1 20 -1 -1 -1 -1 -1 -1 -1 -1 -1 -1 20 20 -1 -1 -1 -1
-1 -1 -1 -1 -1 -1 -1 -1 20 -1 -1 -1 -1 -1 -1 -1 -1 -1 20 20 -1 -1 -1 -1 -1
-1 -1 -1 -1 -1 -1 20 20 20 -1 -1 -1 -1 -1 -1 20 20 20 20 -1 -1 -1 -1 -1 -1
-1 -1 -1 -1 -1 20 20 20 -1 20 20 20 20 20 20 20 -1 -1 -1 -1 -1 -1 -1 -1 -1
-1 -1 -1 -1 20 20 20 -1 -1 -1 -1 -1 -1 -1 -1 -1 -1 -1 -1 -1 -1 -1 -1 -1 -1
-1 -1 -1 20 20 20 -1 -1 -1 -1 -1 -1 -1 -1 -1 -1 -1 -1 -1 -1 -1 -1 -1 -1 -1
-1 -1 -1 -1 -1 -1 -1 -1 -1 -1 -1 -1 -1 -1 -1 -1 -1 -1 -1 -1 -1 -1 -1 -1 -1
-1 -1 -1 -1 -1 -1 -1 -1 -1 -1 -1 -1 -1 -1 -1 -1 -1 -1 -1 -1 -1 -1 -1 -1 -1
-1 -1 -1 -1 -1 -1 -1 -1 -1 -1 20 20 20 -1 -1 -1 -1 -1 -1 -1 -1 -1 -1 -1 -1
20 8 -1 -1 -1 -1 -1 -1 -1 -1 -1 8 8 8 8 8 8 8 20 20 -1 -1 -1 20 20
20 20 -1 -1 -1 -1 -1 -1 -1 -1 -1 48 20 20 20 20 17 20 -1 -1 -1 -1 -1 -1 20
-1 -1 -1 -1 -1 -1 -1 -1 -1 -1 -1 48 -1 -1 -1 20 20 20 20 20 -1 -1 -1 -1 8
-1 -1 -1 -1 -1 -1 -1 -1 -1 -1 -1 48 -1 -1 -1 -1 -1 -1 -1 -1 -1 -1 -1 -1 -1
-1 -1 -1 -1 -1 -1 -1 -1 -1 -1 -1 48 -1 -1 -1 -1 -1 -1 -1 -1 -1 -1 -1 -1 -1
-1 -1 20 -1 -1 -1 -1 -1 -1 -1 -1 48 -1 -1 -1 -1 -1 -1 -1 -1 -1 20 -1 -1 -1
-1 -1 -1 -1 -1 -1 -1 -1 -1 -1 -1 48 -1 -1 -1 -1 -1 -1 -1 -1 8 -1 -1 -1 -1
-1 -1 -1 -1 8 -1 -1 -1 -1 -1 -1 48 -1 -1 -1 -1 -1 -1 -1 -1 -1 -1 -1 -1 -1
-1 -1 -1 -1 -1 -1 -1 -1 -1 -1 -1 48 -1 -1 -1 -1 -1 -1 -1 -1 -1 -1 -1 -1 -1
-1 -1 -1 -1 -1 -1 -1 -1 -1 -1 -1 50 -1 -1 -1 -1 -1 -1 -1 -1 -1 -1 -1 -1 -1
-1 -1 -1 -1 -1 -1 -1 -1 -1 -1 -1 -1 -1 -1 -1 -1 -1 -1 -1 -1 -1 -1 -1 -1 -1
-1 -1 -1 -1 -1 -1 -1 -1 -1 -1 -1 -1 20 -1 -1 -1 -1 -1 -1 -1 -1 -1 -1 -1 -1
-1 -1 -1 -1 -1 -1 -1 -1 20 20 20 20 20 20 20 -1 -1 -1 -1 -1 -1 -1 -1 -1 8
-1 -1 -1 -1 -1 -1 -1 -1 20 20 20 20 20 20 20 -1 -1 -1 -1 -1 -1 -1 -1 -1 48
-1 -1 -1 -1 -1 -1 -1 20 20 20 20 20 20 20 20 -1 -1 -1 -1 -1 -1 -1 -1 -1 48
-1 -1 -1 -1 -1 -1 -1 -1 -1 -1 -1 -1 -1 -1 -1 -1 -1 -1 -1 -1 -1 -1 -1 -1 48
8 -1 -1 -1 -1 -1 -1 -1 -1 -1 -1 -1 -1 -1 -1 -1 -1 -1 8 -1 -1 -1 -1 -1 48
50 -1 -1 -1 -1 -1 -1 -1 -1 -1 -1 -1 -1 -1 -1 -1 -1 -1 17 -1 -1 -1 -1 -1 20
-1 -1 -1 -1 -1 -1 -1 -1 -1 -1 -1 -1 -1 -1 -1 -1 -1 -1 -1 -1 -1 -1 -1 -1 -1
-1 -1 -1 -1 -1 -1 -1 -1 -1 -1 -1 -1 -1 -1 -1 -1 -1 -1 -1 -1 -1 -1 -1 -1 -1
-1 -1 -1 -1 -1 8 -1 -1 -1 -1 -1 -1 -1 -1 -1 -1 -1 -1 -1 -1 -1 -1 -1 -1 -1
-1 -1 -1 -1 -1 20 -1 -1 -1 -1 -1 -1 -1 -1 -1 -1 -1 -1 -1 -1 -1 -1 -1 -1 8
-1 -1 -1 -1 -1 -1 -1 -1 -1 -1 -1 -1 -1 -1 -1 -1 -1 -1 -1 -1 -1 -1 -1 -1 -1
-1 -1 -1 -1 -1 -1 -1 -1 -1 -1 -1 -1 -1 -1 -1 -1 -1 -1 -1 -1 20 -1 -1 -1 -1
-1 -1 -1 -1 -1 -1 -1 -1 -1 -1 -1 -1 -1 -1 -1 -1 -1 -1 -1 -1 -1 -1 -1 -1 -1
-1 -1 -1 -1 -1 -1 -1 -1 -1 -1 -1 -1 -1 -1 -1 -1 -1 -1 -1 8 -1 -1 -1 -1 -1
-1 -1 -1 -1 -1 -1 -1 -1 -1 -1 -1 -1 -1 -1 -1 -1 -1 -1 -1 -1 -1 -1 -1 -1 -1
-1 -1 -1 -1 -1 20 20 20 20 20 20 20 -1 -1 -1 -1 -1 -1 -1 -1 -1 -1 -1 -1 -1
-1 -1 -1 20 -1 20 20 20 20 20 20 20 -1 -1 20 20 -1 -1 -1 -1 -1 -1 -1 -1 -1
-1 20 20 20 20 20 20 20 20 20 20 20 20 20 20 20 -1 -1 -1 -1 -1 -1 -1 -1 -1
-1 20 20 20 20 20 20 20 20 20 20 20 20 20 20 -1 -1 20 20 20 20 -1 -1 -1 -1
20 20 20 20 20 20 -1 20 20 20 20 20 20 20 20 -1 -1 -1 -1 -1 20 20 20 20 20
20 20 20 20 -1 20 -1 -1 -1 20 -1 -1 20 20 20 -1 -1 -1 20 20 20 20 20 20 20
20 20 -1 20 -1 20 -1 -1 20 20 -1 20 20 20 -1 -1 -1 -1 -1 -1 -1 -1 -1 -1 -1
8 8 -1 20 -1 20 -1 -1 20 -1 20 20 -1 20 -1 20 -1 -1 -1 -1 -1 -1 -1 -1 -1
48 48 -1 -1 -1 20 20 -1 20 20 20 -1 -1 -1 -1 -1 -1 -1 -1 -1 -1 -1 -1 -1 -1
20 17 -1 -1 -1 20 20 -1 20 20 20 -1 20 -1 -1 -1 -1 -1 -1 -1 -1 -1 -1 -1 -1
-1 -1 -1 -1 -1 20 8 20 20 20 20 -1 20 -1 -1 -1 -1 -1 -1 -1 -1 -1 -1 -1 -1
-1 -1 -1 -1 -1 20 -1 20 20 20 -1 -1 -1 -1 -1 -1 -1 -1 -1 -1 -1 -1 -1 -1 -1
-1 -1 8 -1 20 20 -1 20 20 20 -1 20 -1 -1 -1 8 -1 -1 -1 -1 -1 -1 -1 -1 -1
-1 -1 48 -1 20 20 -1 -1 -1 20 20 -1 -1 -1 -1 48 -1 -1 -1 -1 -1 -1 -1 -1 -1
-1 -1 48 -1 20 -1 -1 -1 -1 20 -1 -1 -1 -1 -1 48 -1 -1 -1 -1 -1 -1 -1 -1 -1
-1 -1 48 -1 20 -1 -1 -1 -1 20 -1 -1 -1 -1 -1 48 -1 -1 -1 -1 -1 -1 -1 -1 -1
-1 -1 48 -1 -1 -1 -1 -1 -1 20 -1 -1 -1 -1 -1 48 -1 -1 -1 -1 -1 -1 -1 -1 -1
-1 -1 -1 -1 -1 -1 -1 -1 -1 -1 -1 -1 -1 -1 -1 -1 -1 -1 -1 -1 -1 -1 -1 -1 -1
-1 -1 -1 -1 -1 -1 8 -1 -1 -1 20 -1 -1 -1 -1 -1 -1 -1 -1 -1 -1 8 -1 -1 -1
-1 -1 -1 -1 -1 -1 -1 -1 -1 -1 -1 -1 -1 -1 -1 -1 -1 -1 -1 -1 -1 48 -1 -1 -1
-1 -1 -1 -1 -1 -1 -1 -1 -1 -1 -1 -1 -1 -1 -1 8 -1 -1 -1 -1 -1 48 -1 -1 -1
-1 -1 -1 -1 -1 -1 -1 -1 -1 -1 -1 -1 -1 -1 -1 50 -1 -1 -1 -1 -1 48 -1 -1 -1
-1 -1 -1 -1 -1 -1 -1 -1 -1 -1 -1 -1 -1 -1 -1 -1 -1 -1 -1 -1 -1 48 -1 -1 -1
-1 -1 -1 -1 -1 -1 -1 -1 -1 -1 -1 -1 -1 -1 -1 -1 -1 20 -1 -1 -1 -1 -1 -1 -1
-1 -1 -1 -1 -1 -1 -1 -1 -1 -1 -1 -1 -1 -1 -1 -1 -1 -1 -1 -1 -1 -1 -1 -1 -1
-1 -1 -1 8 -1 -1 -1 -1 -1 -1 -1 -1 -1 -1 -1 -1 -1 -1 -1 -1 -1 -1 -1 -1 -1
-1 -1 -1 17 -1 -1 -1 -1 -1 -1 -1 -1 -1 -1 -1 -1 -1 -1 -1 -1 -1 8 20 20 -1
-1 -1 -1 -1 -1 -1 -1 -1 -1 -1 -1 -1 -1 -1 -1 -1 -1 -1 -1 -1 -1 -1 20 20 -1
11 -1 -1 -1 -1 -1 -1 -1 -1 -1 -1 -1 -1 -1 -1 -1 -1 -1 -1 -1 -1 -1 20 20 -1
8 -1 -1 -1 -1 -1 -1 -1 -1 -1 8 -1 -1 -1 -1 -1 -1 -1 -1 -1 -1 -1 20 20 10
-1 -1 -1 -1 -1 -1 -1 -1 -1 -1 -1 -1 -1 -1 -1 -1 -1 -1 -1 -1 -1 -1 20 8 8
-1 -1 -1 -1 -1 -1 -1 -1 -1 -1 -1 -1 -1 -1 -1 -1 -1 -1 -1 -1 -1 -1 20 20 17
-1 -1 -1 -1 -1 -1 -1 -1 -1 -1 -1 -1 -1 -1 -1 -1 -1 -1 -1 -1 -1 -1 -1 -1 -1
-1 -1 -1 -1 -1 -1 -1 -1 -1 -1 -1 -1 -1 20 20 20 20 20 20 20 20 20 -1 -1 -1
-1 -1 -1 20 -1 -1 -1 -1 -1 -1 -1 -1 -1 -1 -1 20 20 20 20 20 20 20 20 20 -1
20 20 20 8 -1 -1 -1 -1 -1 -1 -1 -1 -1 -1 -1 20 20 20 20 20 20 20 20 20 -1
-1 -1 20 48 -1 -1 -1 -1 -1 -1 -1 -1 -1 -1 -1 -1 20 20 -1 -1 20 20 20 -1 20
-1 -1 20 48 -1 -1 -1 -1 -1 -1 -1 -1 -1 -1 -1 -1 20 20 20 20 20 20 -1 -1 -1
-1 -1 20 48 11 -1 -1 -1 -1 -1 -1 -1 -1 -1 -1 20 20 20 20 20 20 20 20 -1 -1
-1 -1 20 48 8 8 -1 -1 -1 -1 -1 -1 -1 -1 -1 20 20 20 20 20 20 20 20 20 20
-1 -1 20 50 -1 -1 -1 -1 -1 -1 -1 -1 -1 -1 -1 -1 -1 -1 -1 -1 -1 -1 -1 -1 -1
-1 -1 -1 -1 -1 -1 -1 -1 -1 -1 -1 -1 -1 -1 -1 -1 -1 -1 -1 -1 -1 -1 -1 -1 12
-1 -1 -1 -1 -1 -1 -1 -1 20 20 20 20 20 20 20 20 20 -1 -1 -1 -1 -1 -1 -1 8
-1 -1 -1 -1 -1 -1 -1 -1 20 20 20 20 20 20 20 20 20 -1 -1 -1 -1 -1 -1 -1 -1
-1 -1 -1 -1 -1 -1 -1 -1 20 20 20 20 20 20 20 20 20 -1 -1 -1 -1 -1 -1 -1 -1
-1 -1 -1 -1 -1 -1 -1 -1 -1 -1 -1 -1 -1 -1 -1 -1 -1 -1 -1 -1 -1 -1 -1 -1 -1
-1 -1 -1 20 20 20 -1 -1 -1 -1 -1 -1 -1 -1 -1 -1 -1 -1 -1 8 -1 -1 -1 -1 -1
-1 -1 -1 8 8 8 -1 -1 -1 -1 -1 -1 -1 -1 -1 -1 -1 -1 -1 -1 -1 -1 -1 -1 -1
-1 -1 -1 17 -1 -1 -1 -1 -1 -1 -1 -1 -1 -1 -1 -1 -1 -1 -1 -1 -1 -1 -1 -1 -1
-1 -1 -1 -1 -1 -1 -1 -1 -1 -1 -1 -1 -1 -1 -1 -1 -1 -1 -1 -1 -1 -1 -1 -1 10
-1 -1 -1 -1 -1 -1 -1 -1 -1 -1 -1 -1 -1 -1 -1 -1 -1 -1 -1 -1 -1 -1 -1 20 8
8 -1 -1 -1 -1 -1 -1 -1 -1 -1 -1 -1 -1 -1 -1 -1 -1 -1 20 -1 -1 -1 -1 -1 50
-1 -1 -1 -1 -1 -1 -1 -1 -1 -1 -1 -1 -1 -1 -1 -1 -1 -1 20 20 -1 -1 -1 -1 -1
-1 -1 -1 -1 20 -1 -1 -1 -1 -1 -1 -1 -1 -1 -1 -1 -1 -1 20 20 8 20 20 20 20
-1 -1 -1 -1 -1 -1 -1 -1 -1 -1 -1 -1 -1 -1 -1 -1 8 -1 20 20 20 20 20 20 20
20 -1 -1 -1 -1 -1 -1 -1 -1 -1 -1 -1 -1 -1 -1 -1 48 20 20 20 20 20 20 20 20
8 -1 20 20 8 -1 -1 -1 -1 -1 -1 -1 -1 -1 -1 -1 48 20 20 20 20 20 20 20 20
48 -1 20 20 48 -1 -1 -1 -1 -1 -1 -1 -1 -1 -1 -1 48 20 20 20 20 20 20 20 20
48 -1 20 20 48 -1 -1 -1 -1 -1 -1 -1 -1 -1 -1 -1 17 20 20 20 20 20 20 20 20
48 -1 20 20 48 -1 -1 -1 -1 -1 -1 -1 -1 -1 -1 -1 20 20 20 20 20 20 20 20 20
48 -1 20 20 48 -1 -1 -1 -1 -1 -1 -1 -1 -1 -1 -1 20 20 20 20 8 20 20 20 20
48 -1 20 20 48 -1 -1 -1 -1 -1 -1 -1 -1 -1 -1 -1 20 20 20 20 20 20 20 20 8
48 -1 20 20 48 -1 -1 -1 -1 -1 -1 -1 -1 -1 -1 -1 -1 20 20 20 20 20 20 20 48
48 -1 20 20 48 -1 -1 -1 -1 -1 -1 -1 -1 -1 -1 -1 -1 -1 -1 -1 -1 20 20 20 48
48 -1 20 20 48 -1 -1 -1 -1 20 -1 -1 20 -1 -1 -1 -1 -1 -1 -1 -1 -1 20 20 48
48 -1 20 20 48 -1 -1 -1 -1 -1 -1 -1 -1 -1 -1 -1 -1 -1 -1 -1 -1 -1 -1 20 -1
48 -1 20 20 48 -1 -1 -1 20 20 20 20 20 -1 -1 -1 -1 -1 -1 -1 -1 -1 -1 -1 -1
20 -1 20 20 20 20 -1 -1 20 20 20 20 20 -1 -1 -1 -1 -1 -1 -1 8 -1 -1 -1 -1
20 -1 20 20 20 -1 -1 -1 20 20 20 20 20 -1 -1 -1 -1 20 20 20 20 20 20 20 20
20 -1 20 20 -1 -1 -1 -1 -1 -1 -1 -1 -1 -1 -1 -1 -1 -1 -1 -1 -1 -1 20 20 -1
20 -1 20 -1 -1 -1 -1 -1 -1 -1 -1 -1 -1 -1 -1 -1 -1 -1 -1 -1 -1 -1 -1 -1 -1
13 18 20 -1 -1 -1 -1 -1 -1 -1 -1 -1 -1 -1 -1 -1 -1 -1 -1 -1 -1 -1 -1 -1 -1
8 8 8 8 8 -1 -1 -1 -1 -1 -1 -1 -1 -1 -1 -1 -1 -1 -1 -1 -1 -1 -1 -1 -1
-1 20 -1 50 -1 -1 -1 -1 -1 20 20 20 20 20 20 -1 -1 -1 -1 -1 -1 -1 -1 -1 20
-1 -1 -1 -1 -1 -1 -1 -1 -1 20 -1 -1 -1 20 20 20 -1 -1 -1 -1 -1 -1 -1 -1 -1
-1 -1 -1 -1 -1 -1 -1 4 20 52 -1 -1 -1 -1 -1 -1 -1 -1 -1 -1 -1 -1 -1 -1 -1
-1 -1 -1 -1 -1 -1 -1 0 0 0 -1 -1 -1 -1 -1 -1 -1 -1 -1 -1 -1 -1 -1 -1 -1
-1 -1 -1 20 20 20 20 44 -1 -1 -1 -1 -1 -1 -1 52 53 -1 20 20 20 -1 -1 -1 -1
-1 -1 -1 20 20 20 20 -1 -1 -1 -1 -1 -1 -1 0 0 0 0 -1 -1 -1 -1 -1 -1 -1
-1 -1 -1 20 20 20 20 -1 -1 -1 -1 -1 -1 -1 37 -1 44 20 -1 -1 -1 -1 -1 -1 -1
5 52 20 -1 -1 -1 -1 -1 -1 -1 -1 -1 -1 -1 37 -1 -1 -1 -1 -1 -1 -1 -1 52 20
0 0 0 -1 -1 -1 -1 -1 -1 -1 -1 -1 -1 -1 37 -1 -1 -1 -1 -1 -1 20 20 0 0
-1 -1 -1 -1 -1 -1 -1 -1 -1 -1 -1 -1 -1 -1 37 -1 -1 -1 -1 -1 -1 -1 20 20 44
-1 -1 -1 -1 -1 -1 -1 -1 -1 -1 -1 -1 -1 -1 21 -1 -1 -1 -1 -1 4 -1 20 20 20
-1 -1 -1 -1 -1 -1 -1 -1 -1 -1 -1 -1 -1 -1 20 -1 -1 -1 -1 0 0 -1 -1 -1 20
-1 -1 -1 -1 -1 -1 -1 -1 -1 -1 -1 -1 -1 -1 20 -1 -1 -1 -1 -1 -1 -1 -1 -1 -1
-1 -1 -1 -1 -1 -1 -1 -1 -1 -1 -1 -1 -1 -1 20 -1 -1 -1 -1 -1 -1 -1 -1 -1 -1
-1 -1 -1 -1 -1 52 -1 -1 -1 -1 -1 -1 -1 -1 -1 -1 -1 -1 -1 -1 -1 -1 -1 -1 -1
4 -1 -1 -1 0 0 20 20 20 -1 -1 -1 -1 -1 0 0 0 -1 -1 -1 -1 -1 -1 -1 -1
0 -1 -1 20 44 -1 -1 -1 -1 -1 -1 -1 -1 -1 -1 -1 44 -1 -1 -1 -1 -1 -1 -1 -1
37 -1 -1 -1 -1 -1 -1 -1 -1 -1 -1 -1 -1 -1 -1 -1 -1 -1 -1 -1 -1 -1 -1 -1 -1
37 -1 -1 -1 -1 -1 -1 -1 -1 -1 5 -1 -1 -1 -1 -1 -1 -1 -1 -1 -1 -1 -1 -1 -1
37 -1 -1 -1 -1 -1 -1 -1 -1 0 0 -1 -1 -1 -1 -1 -1 -1 -1 -1 -1 -1 -1 -1 -1
21 -1 -1 -1 20 20 -1 -1 -1 -1 -1 -1 -1 -1 -1 -1 -1 -1 -1 -1 -1 -1 -1 -1 -1
-1 -1 -1 -1 -1 20 20 -1 -1 -1 -1 -1 -1 -1 -1 -1 -1 -1 -1 -1 -1 -1 -1 -1 -1
-1 -1 -1 -1 -1 -1 -1 -1 -1 -1 -1 -1 20 20 20 20 20 52 -1 -1 -1 -1 -1 -1 -1
-1 -1 -1 20 4 52 3 20 20 -1 -1 -1 20 20 20 0 0 0 20 20 20 -1 -1 -1 -1
-1 -1 -1 20 0 0 0 20 20 -1 -1 -1 20 20 20 20 44 -1 -1 -1 -1 -1 -1 -1 -1
-1 -1 -1 20 20 20 20 20 -1 -1 -1 -1 20 -1 20 -1 20 20 -1 20 -1 -1 -1 -1 -1
-1 -1 -1 -1 -1 -1 -1 -1 -1 -1 -1 -1 20 -1 20 -1 -1 -1 20 20 -1 -1 -1 -1 -1
-1 -1 -1 -1 -1 -1 -1 -1 -1 -1 -1 -1 20 -1 20 -1 -1 -1 -1 20 -1 -1 -1 -1 -1
-1 -1 -1 -1 -1 -1 5 52 -1 -1 -1 -1 20 20 20 -1 -1 -1 -1 20 -1 52 -1 5 -1
-1 -1 -1 -1 -1 0 0 0 -1 -1 -1 -1 20 20 -1 -1 -1 -1 -1 20 0 0 0 0 -1
-1 -1 -1 -1 -1 44 -1 20 20 20 20 20 20 20 -1 -1 -1 -1 -1 20 -1 -1 -1 44 -1
-1 -1 -1 -1 -1 -1 -1 -1 -1 20 20 20 20 20 20 20 20 -1 -1 20 -1 -1 -1 -1 -1
3 -1 -1 -1 -1 -1 -1 -1 -1 20 20 20 -1 -1 -1 -1 20 20 20 -1 -1 -1 -1 -1 -1
0 -1 -1 -1 -1 -1 -1 -1 20 20 -1 20 -1 -1 0 0 20 20 20 20 20 20 20 20 20
37 -1 -1 -1 -1 -1 -1 -1 20 20 20 20 -1 -1 -1 -1 -1 -1 -1 -1 -1 -1 -1 -1 -1
37 -1 -1 -1 20 -1 -1 -1 20 20 20 -1 -1 -1 -1 -1 -1 -1 -1 -1 -1 -1 -1 -1 -1
37 -1 -1 -1 20 -1 -1 -1 20 20 4 -1 -1 -1 -1 -1 -1 -1 20 -1 -1 -1 -1 -1 -1
44 -1 -1 -1 20 -1 -1 -1 -1 0 0 -1 -1 -1 -1 -1 -1 -1 20 -1 -1 -1 -1 -1 -1
-1 -1 -1 20 20 20 20 20 -1 44 20 -1 -1 -1 -1 -1 -1 -1 -1 -1 -1 -1 20 -1 -1
-1 -1 -1 -1 20 20 20 20 20 20 20 -1 -1 -1 -1 -1 -1 -1 -1 -1 -1 -1 20 -1 -1
-1 -1 -1 -1 -1 -1 -1 -1 20 20 20 -1 -1 -1 -1 -1 -1 -1 -1 -1 -1 -1 -1 -1 -1
-1 -1 -1 -1 -1 20 20 20 20 -1 -1 -1 -1 -1 20 -1 -1 -1 -1 -1 -1 -1 -1 -1 -1
53 52 -1 -1 -1 -1 -1 -1 -1 -1 -1 -1 -1 -1 20 52 5 -1 -1 -1 -1 -1 -1 -1 -1
0 0 -1 -1 -1 -1 -1 -1 -1 -1 -1 -1 -1 -1 0 0 0 0 0 -1 -1 -1 -1 -1 -1
-1 -1 -1 -1 -1 -1 -1 -1 -1 -1 -1 -1 -1 -1 44 20 20 20 20 -1 -1 -1 -1 -1 -1
-1 -1 -1 -1 -1 -1 -1 -1 -1 -1 -1 -1 -1 -1 -1 -1 3 -1 -1 -1 -1 -1 -1 -1 -1
-1 -1 -1 -1 -1 -1 -1 20 20 20 -1 -1 -1 -1 -1 0 0 0 -1 -1 -1 -1 -1 -1 -1
-1 -1 -1 0 -1 -1 -1 20 20 -1 -1 -1 -1 -1 -1 -1 37 -1 -1 -1 -1 -1 -1 -1 -1
-1 -1 -1 44 -1 -1 -1 -1 -1 -1 -1 -1 -1 -1 -1 -1 37 -1 -1 -1 -1 -1 -1 52 4
-1 -1 -1 -1 -1 -1 -1 -1 -1 -1 -1 -1 -1 -1 -1 -1 37 -1 -1 -1 -1 -1 -1 0 0
-1 -1 -1 -1 -1 -1 5 52 -1 -1 -1 -1 -1 -1 -1 -1 37 -1 -1 -1 -1 -1 -1 -1 20
-1 -1 -1 -1 -1 0 0 0 0 -1 -1 -1 -1 -1 -1 -1 21 -1 -1 -1 -1 -1 -1 -1 -1
20 20 20 20 20 20 20 20 20 20 20 20 20 20 20 20 20 20 20 -1 -1 -1 -1 -1 -1
20 20 20 20 20 20 20 20 20 20 20 20 20 20 20 20 20 20 20 20 -1 -1 -1 -1 -1
20 20 20 20 20 20 20 20 20 20 20 20 20 20 20 20 20 20 20 20 20 20 -1 -1 -1
20 20 20 20 20 20 20 20 20 20 20 20 20 20 20 53 52 20 20 -1 -1 -1 -1 -1 -1
20 20 20 20 20 20 20 20 20 20 20 20 20 20 0 0 0 0 0 20 -1 -1 -1 -1 -1
20 20 20 20 20 52 20 20 20 20 20 20 20 20 20 20 20 17 -1 -1 -1 -1 -1 -1 -1
20 20 20 20 20 0 0 0 20 20 20 20 20 20 20 20 20 20 20 20 20 20 20 20 -1
20 20 20 20 20 20 20 44 20 20 20 20 20 20 20 20 20 20 20 20 20 20 20 0 0
20 20 20 20 20 20 20 20 20 20 20 20 20 20 20 20 20 20 20 20 20 20 20 44 20
0 20 20 20 20 20 20 20 20 20 20 20 20 20 20 20 20 20 -1 -1 -1 -1 -1 -1 -1
20 20 20 20 20 20 3 20 20 20 20 20 20 20 20 20 20 20 -1 -1 -1 -1 -1 -1 -1
20 20 20 20 20 20 0 20 20 20 20 20 20 20 20 20 20 20 -1 -1 -1 -1 20 20 20
20 20 20 20 20 20 37 20 20 20 20 20 20 20 20 20 5 20 20 20 -1 -1 -1 -1 -1
20 52 20 20 20 20 37 20 20 20 20 20 20 20 20 28 0 0 34 20 20 -1 -1 -1 -1
0 0 0 20 20 20 37 20 20 20 20 20 20 20 20 36 37 37 32 20 20 20 20 20 52
44 20 20 20 20 20 37 20 20 20 20 20 20 20 20 33 21 21 35 20 20 20 20 0 0
-1 -1 -1 -1 -1 -1 37 -1 -1 -1 -1 -1 -1 20 20 20 20 44 20 20 -1 -1 -1 -1 20
-1 -1 -1 -1 -1 -1 21 -1 -1 -1 20 20 -1 -1 -1 20 20 20 20 20 -1 -1 -1 20 20
-1 -1 -1 -1 -1 -1 -1 -1 -1 -1 -1 -1 -1 -1 -1 20 20 20 20 20 -1 -1 -1 20 20
-1 -1 -1 -1 -1 -1 -1 -1 -1 -1 -1 -1 -1 -1 -1 20 20 20 20 20 0 0 -1 20 20
-1 -1 -1 -1 -1 -1 -1 -1 -1 -1 -1 -1 -1 -1 -1 20 20 20 20 20 -1 -1 20 20 20
-1 -1 -1 -1 4 52 20 20 20 -1 -1 -1 -1 -1 -1 20 20 20 20 20 -1 20 -1 20 20
-1 -1 -1 -1 0 0 0 0 20 20 20 20 -1 -1 -1 -1 -1 -1 -1 -1 -1 20 -1 20 20
-1 -1 -1 -1 -1 -1 -1 -1 -1 -1 -1 -1 -1 52 -1 -1 -1 -1 -1 20 20 20 -1 0 0
-1 -1 -1 -1 -1 -1 -1 -1 -1 -1 -1 -1 -1 0 0 0 -1 -1 20 -1 20 20 -1 44 20
-1 -1 -1 -1 -1 -1 -1 -1 -1 -1 -1 -1 -1 -1 -1 -1 -1 -1 20 -1 -1 -1 -1 20 20
-1 -1 -1 -1 -1 -1 -1 -1 -1 -1 -1 -1 -1 -1 -1 -1 -1 -1 20 -1 -1 -1 -1 20 20
-1 -1 -1 -1 -1 -1 -1 -1 -1 -1 -1 -1 -1 -1 -1 -1 -1 -1 20 -1 -1 -1 4 20 20
-1 -1 -1 -1 -1 -1 -1 -1 -1 -1 -1 -1 -1 -1 -1 -1 -1 -1 20 -1 0 0 0 0 0
-1 -1 -1 -1 -1 -1 -1 28 34 -1 -1 -1 -1 -1 -1 20 -1 -1 20 -1 -1 44 -1 20 20
-1 -1 -1 -1 -1 -1 -1 33 35 -1 -1 -1 -1 -1 -1 -1 -1 -1 -1 -1 -1 -1 -1 20 20
-1 -1 -1 -1 -1 -1 -1 44 20 -1 -1 -1 -1 -1 -1 -1 -1 -1 -1 -1 -1 -1 -1 20 20
20 20 20 20 20 20 20 20 20 20 20 20 20 0 20 20 20 20 -1 -1 -1 -1 -1 20 -1
0 20 20 20 0 20 20 20 20 20 20 20 20 20 20 20 20 20 20 -1 -1 -1 -1 20 -1
37 20 20 20 37 20 20 20 20 20 20 20 20 20 20 20 20 20 -1 -1 -1 -1 -1 -1 -1
37 20 20 20 37 20 20 20 20 20 20 20 20 20 20 20 52 5 -1 -1 -1 -1 -1 -1 -1
37 20 20 20 37 20 20 20 20 20 20 20 20 20 20 20 0 0 0 20 -1 -1 -1 -1 -1
37 20 20 20 37 20 20 20 20 20 20 20 20 20 20 20 20 20 20 20 -1 -1 -1 -1 -1
37 20 20 20 37 20 20 20 20 20 20 20 20 20 20 20 20 20 -1 -1 -1 -1 -1 53 -1
37 20 20 20 37 20 20 20 20 20 20 20 20 20 20 20 20 20 -1 -1 -1 -1 20 0 0
37 20 20 20 37 20 20 20 20 20 20 20 20 20 20 20 20 20 -1 -1 -1 -1 -1 20 -1
21 20 20 20 21 20 20 20 20 20 20 20 20 20 20 20 20 20 -1 20 -1 -1 -1 20 20
44 20 20 20 20 20 20 20 20 20 20 20 20 20 20 20 20 20 20 20 0 0 -1 -1 -1
20 20 20 20 20 20 20 20 20 20 20 20 20 20 20 20 20 20 20 20 44 -1 -1 -1 -1
20 20 20 20 20 20 20 20 20 20 20 20 20 20 20 20 20 20 20 20 -1 -1 -1 -1 20
20 20 20 20 20 20 20 20 20 20 20 20 20 20 20 20 20 20 -1 -1 -1 -1 -1 20 20
20 53 52 20 20 20 20 20 4 52 20 20 20 20 20 52 3 20 -1 -1 5 20 20 20 20
0 0 0 0 0 0 0 0 0 0 0 0 0 0 0 0 0 0 0 0 0 0 0 0 0