14 14
1 1 1 1 1 1 1 1 1 1 1 1 -1 -1
1 1 1 1 1 1 1 1 1 1 1 1 -1 -1
1 1 1 1 1 1 1 1 1 1 1 1 -1 -1
1 3 1 1 1 1 1 1 1 1 1 1 1 1
1 1 1 1 1 1 1 1 1 1 1 1 1 1
1 1 1 1 1 1 1 1 1 1 1 1 1 1
1 1 1 1 1 1 1 1 1 1 1 1 1 1
1 1 1 1 1 1 1 1 1 1 1 1 1 1
1 1 1 1 1 8 8 8 1 1 1 1 1 1
1 1 1 1 1 8 8 8 1 1 1 1 1 1
1 1 1 1 1 1 7 1 1 1 1 1 1 1
1 1 1 1 1 1 7 1 1 1 1 19 20 0
0 0 0 0 0 0 0 14 14 14 0 0 0 0
2 2 2 2 2 2 2 16 16 16 2 2 2 2